########
#2··bB##
#a···#@#
#···1·A#
#······#
#······#
#······#
#·c·C··#
########
