########
#c····##
#a@··A##
#b·BC#·#
#1·····#
########
