########
#·2···##
#a···#@#
#···1·A#
########